 /######## /##                                      /######  /##                                               /##
| ##_____/| ##                                     /##__  ##| ##                                              | ##
| ##      | ##  /######   /######   /######       | ##  \__/| ##  /######   /######   /######   /######   /#######
| #####   | ## /##__  ## /##__  ## /##__  ##      | ##      | ## /##__  ## |____  ## /##__  ## /##__  ## /##__  ##
| ##__/   | ##| ##  \ ##| ##  \ ##| ##  \__/      | ##      | ##| ########  /#######| ##  \__/| ########| ##  | ##
| ##      | ##| ##  | ##| ##  | ##| ##            | ##    ##| ##| ##_____/ /##__  ##| ##      | ##_____/| ##  | ##
| ##      | ##|  ######/|  ######/| ##            |  ######/| ##|  #######|  #######| ##      |  #######|  #######
|__/      |__/ \______/  \______/ |__/             \______/ |__/ \_______/ \_______/|__/       \_______/ \_______/
                                                                                                                  